stdout of test '74` in directory 'sql/benchmarks/tpcds` itself:


# 18:29:58 >  
# 18:29:58 >  "mserver5" "--debug=10" "--set" "gdk_nr_threads=0" "--set" "mapi_open=true" "--set" "mapi_port=30709" "--set" "mapi_usock=/var/tmp/mtest-16393/.s.monetdb.30709" "--set" "monet_prompt=" "--forcemito" "--dbpath=/ufs/sjoerd/@Monet-devel/var/MonetDB/mTests_sql_benchmarks_tpcds" "--set" "embedded_c=true"
# 18:29:58 >  

# MonetDB 5 server v11.32.0 (hg id: edafb9f9a3c6+79d16e518d38+)
# This is an unreleased version
# Serving database 'mTests_sql_benchmarks_tpcds', using 8 threads
# Compiled for x86_64-pc-linux-gnu/64bit with 128bit integers
# Found 62.694 GiB available main-memory.
# Copyright (c) 1993 - July 2008 CWI.
# Copyright (c) August 2008 - 2019 MonetDB B.V., all rights reserved
# Visit https://www.monetdb.org/ for further information
# Listening for connection requests on mapi:monetdb://methuselah.da.cwi.nl:30709/
# Listening for UNIX domain connection requests on mapi:monetdb:///var/tmp/mtest-16393/.s.monetdb.30709
# MonetDB/GIS module loaded
# MonetDB/SQL module loaded

Ready.

# 18:29:58 >  
# 18:29:58 >  "mclient" "-lsql" "-ftest" "-tnone" "-Eutf-8" "-i" "-e" "--host=/var/tmp/mtest-16393" "--port=30709"
# 18:29:58 >  

#WITH year_total AS
#  (SELECT c_customer_id customer_id,
#          c_first_name customer_first_name,
#          c_last_name customer_last_name,
#          d_year AS year_,
#          sum(ss_net_paid) year_total,
#          's' sale_type
#   FROM customer,
#        store_sales,
#        date_dim
#   WHERE c_customer_sk = ss_customer_sk
#     AND ss_sold_date_sk = d_date_sk
% .t_s_secyear,	.t_s_secyear,	.t_s_secyear # table_name
% customer_id,	customer_first_name,	customer_last_name # name
% char,	char,	char # type
% 16,	20,	30 # length
[ "AAAAAAAAAMGDAAAA",	"Kenneth",	"Harlan"	]
[ "AAAAAAAAANFAAAAA",	"Philip",	"Banks"	]
[ "AAAAAAAAAOPFBAAA",	"Jerry",	"Fields"	]
[ "AAAAAAAABLEIBAAA",	"Paula",	"Wakefield"	]
[ "AAAAAAAABNBBAAAA",	"Irma",	"Smith"	]
[ "AAAAAAAACADPAAAA",	"Cristobal",	"Thomas"	]
[ "AAAAAAAACFCGBAAA",	"Marcus",	"Sanders"	]
[ "AAAAAAAACFENAAAA",	"Christopher",	"Dawson"	]
[ "AAAAAAAACIJMAAAA",	"Elizabeth",	"Thomas"	]
[ "AAAAAAAACJDIAAAA",	"James",	"Kerr"	]
[ "AAAAAAAACNAGBAAA",	"Virginia",	"May"	]
[ "AAAAAAAADBEFBAAA",	"Bennie",	"Bowers"	]
[ "AAAAAAAADCKOAAAA",	"Robert",	"Gonzalez"	]
[ "AAAAAAAADFIEBAAA",	"John",	"Gray"	]
[ "AAAAAAAADFKABAAA",	"Latoya",	"Craft"	]
[ "AAAAAAAADIIOAAAA",	"David",	"Carroll"	]
[ "AAAAAAAADIJGBAAA",	"Ruth",	"Sanders"	]
[ "AAAAAAAADLHBBAAA",	"Henry",	"Bertrand"	]
[ "AAAAAAAAEADJAAAA",	"Ruth",	"Carroll"	]
[ "AAAAAAAAEJDLAAAA",	"Alice",	"Wright"	]
[ "AAAAAAAAEKFPAAAA",	"Annika",	"Chin"	]
[ "AAAAAAAAEKJLAAAA",	"Aisha",	"Carlson"	]
[ "AAAAAAAAEOAKAAAA",	"Molly",	"Benjamin"	]
[ "AAAAAAAAEPOGAAAA",	"Felisha",	"Mendes"	]
[ "AAAAAAAAFACEAAAA",	"Priscilla",	"Miller"	]
[ "AAAAAAAAFBAHAAAA",	"Michael",	"Williams"	]
[ "AAAAAAAAFGIGAAAA",	"Eduardo",	"Miller"	]
[ "AAAAAAAAFGPGAAAA",	"Albert",	"Wadsworth"	]
[ "AAAAAAAAFHACBAAA",	NULL,	NULL	]
[ "AAAAAAAAFJHFAAAA",	"Larissa",	"Roy"	]
[ "AAAAAAAAFMHIAAAA",	"Emilio",	"Darling"	]
[ "AAAAAAAAFOGIAAAA",	"Michelle",	"Greene"	]
[ "AAAAAAAAFOJAAAAA",	"Don",	"Castillo"	]
[ "AAAAAAAAGEHIAAAA",	"Tyler",	"Miller"	]
[ "AAAAAAAAGFMDBAAA",	"Kathleen",	"Gibson"	]
[ "AAAAAAAAGHPBBAAA",	"Nick",	"Mendez"	]
[ "AAAAAAAAGNDAAAAA",	"Terry",	"Mcdowell"	]
[ "AAAAAAAAHGOABAAA",	"Sonia",	"White"	]
[ "AAAAAAAAHHCABAAA",	"William",	"Stewart"	]
[ "AAAAAAAAHJLAAAAA",	"Audrey",	"Beltran"	]
[ "AAAAAAAAHMJNAAAA",	"Ryan",	"Baptiste"	]
[ "AAAAAAAAHMOIAAAA",	"Grace",	"Henderson"	]
[ "AAAAAAAAHNFHAAAA",	"Rebecca",	"Wilson"	]
[ "AAAAAAAAIADEBAAA",	"Diane",	"Aldridge"	]
[ "AAAAAAAAIBAEBAAA",	"Sandra",	"Wilson"	]
[ "AAAAAAAAIBFCBAAA",	"Ruth",	"Grantham"	]
[ "AAAAAAAAIBHHAAAA",	"Jennifer",	"Ballard"	]
[ "AAAAAAAAICHFAAAA",	"Linda",	"Mccoy"	]
[ "AAAAAAAAIDKFAAAA",	"Michael",	"Mack"	]
[ "AAAAAAAAIJEMAAAA",	"Charlie",	"Cummings"	]
[ "AAAAAAAAIMHBAAAA",	"Kathy",	"Knowles"	]
[ "AAAAAAAAIMHHBAAA",	"Lillian",	"Davidson"	]
[ "AAAAAAAAJEKFBAAA",	"Norma",	"Burkholder"	]
[ "AAAAAAAAJGMMAAAA",	"Richard",	"Larson"	]
[ "AAAAAAAAJIALAAAA",	"Santos",	"Gutierrez"	]
[ "AAAAAAAAJKBNAAAA",	"Julie",	"Kern"	]
[ "AAAAAAAAJONHBAAA",	"Warren",	"Orozco"	]
[ "AAAAAAAAKAECAAAA",	"Milton",	"Mackey"	]
[ "AAAAAAAAKBCABAAA",	"Debra",	"Bell"	]
[ "AAAAAAAAKJBKAAAA",	"Georgia",	"Scott"	]
[ "AAAAAAAAKJBLAAAA",	"Kerry",	"Davis"	]
[ "AAAAAAAAKKGEAAAA",	"Katie",	"Dunbar"	]
[ "AAAAAAAAKLHHBAAA",	"Manuel",	"Castaneda"	]
[ "AAAAAAAAKNAKAAAA",	"Gladys",	"Banks"	]
[ "AAAAAAAAKOJJAAAA",	"Gracie",	"Mendoza"	]
[ "AAAAAAAALFKKAAAA",	"Ignacio",	"Miller"	]
[ "AAAAAAAALHMCAAAA",	"Brooke",	"Nelson"	]
[ "AAAAAAAALIOPAAAA",	"Derek",	"Allen"	]
[ "AAAAAAAALJNCBAAA",	"George",	"Gamez"	]
[ "AAAAAAAAMDCAAAAA",	"Louann",	"Hamel"	]
[ "AAAAAAAAMFFLAAAA",	"Margret",	"Gray"	]
[ "AAAAAAAAMMOBBAAA",	"Margaret",	"Smith"	]
[ "AAAAAAAANFBDBAAA",	"Vernice",	"Fernandez"	]
[ "AAAAAAAANGDBBAAA",	"Carlos",	"Jewell"	]
[ "AAAAAAAANIPLAAAA",	"Eric",	"Lawrence"	]
[ "AAAAAAAANJAGAAAA",	"Allen",	"Hood"	]
[ "AAAAAAAANJHCBAAA",	"Christopher",	"Schreiber"	]
[ "AAAAAAAAOBADBAAA",	"Elizabeth",	"Burnham"	]
[ "AAAAAAAAOCAJAAAA",	"Jenna",	"Staton"	]
[ "AAAAAAAAOCDJAAAA",	"Nina",	"Sanchez"	]
[ "AAAAAAAAOCICAAAA",	"Zachary",	"Pennington"	]
[ "AAAAAAAAOCLBBAAA",	NULL,	NULL	]
[ "AAAAAAAAOFLCAAAA",	"James",	"Taylor"	]
[ "AAAAAAAAOPDLAAAA",	"Ann",	"Pence"	]
[ "AAAAAAAAPDFBAAAA",	"Terrance",	"Banks"	]
[ "AAAAAAAAPEHEBAAA",	"Edith",	"Molina"	]
[ "AAAAAAAAPFCLAAAA",	"Felicia",	"Neville"	]
[ "AAAAAAAAPJENAAAA",	"Ashley",	"Norton"	]
[ "AAAAAAAAPKBCBAAA",	"Andrea",	"White"	]
[ "AAAAAAAAPKIKAAAA",	"Wendy",	"Horvath"	]
[ "AAAAAAAAPMMBBAAA",	"Paul",	"Jordan"	]
[ "AAAAAAAAPPIBBAAA",	"Candice",	"Lee"	]

# 18:29:58 >  
# 18:29:58 >  "Done."
# 18:29:58 >  
